0000000000000000000000000
0000000000000000000000000
00000xxx00000000000000000
00xxxx0xx0x00000000000000
0xxxxx0xxxxxxxxx000000000
00xxxx0xxx0x00x0000000000
00000xxx00x0x000000000000
0000000000000000000000000